................................
.                              .
.       nnnnnnnn               .
.       nnnnnnnn               .
.                              .
.                              .
.     $$$$$$$$$$$$$$$$$$       .
.     $$$$$$$$$$$$$$$$$$       .
.     $$$$$$$$$$$$$$$$$$       .
.     $$$$$$$$$$$$$$$$$$       .
.                              .
.       ^^^                NNNN.
.       ^^^              NNNN  .
.       ^^^^^^^          NNNN  .
.          ^^^^             N  .
.          ^^^^             N  .
.                           N  .
.                        NNNN  .
.                              .
.           ))))))))           .
.           ))))))))    NN     .
.           ))))))))    NN     .
.               ))))))         .
.               ))))))         .
.                              .
.                              .
.                              .
.                              .
.                              .
.                              .
.                              .
................................
