................................
.                              .
.                              .
.                              .
.                              .
.                              .
.     $$$$$$$$$$$$$$$$$$       .
.     $$$$$$$$$$$$$$$$$$       .
.     $$$$$$$$$$$$$$$$$$       .
.     $$$$$$$$$$$$$$$$$$       .
.     $$$$$$$$$$$$$$$$$$       .
.     $$$$$$$$$$$$$$$$$$       .
.                              .
.                              .
.                              .
.                              .
.                              .
.                              .
.                              .
.                              .
.                              .
.                              .
.                              .
.                              .
.                              .
.                              .
.                              .
.                              .
.                              .
.                              .
.                              .
................................
