................................
.                              .
.       nnnnn                  .
.        nnnnnnn               .
.           n      n           .
.           n                  .
.     $$$$$$$$$$$$$$$$$$       .
.     $$$$$$$$$$$$$$$$$$       .
.     $$$$$$$$$$$$$$$$$$       .
.     $$$$$$$$$$$$$$$$$$       .
.                              .
.        ^                 NNNN.
.        ^^              NNNN  .
.       ^^^^^^^          NNNN  .
.          ^^^^             N  .
.          ^^^^             N  .
.                           N  .
.               ^        NNNN  .
.                              .
.           ))))))))           .
.           ))))))))     N     .
.           ))))))))           .
.               ))))))         .
.               ))))))         .
.                              .
.                              .
.                              .
.                              .
.                              .
.                              .
.                              .
................................
